

EA  textures/simonkraft/respawn_anchor_side2.xpm



SO textures/simonkraft/respawn_anchor_side4.xpm



WE textures/simonkraft/respawn_anchor_side3.xpm




NO textures/simonkraft/respawn_anchor_side0.xpm 

C 2,40,4
F 10,6,0


11111111111111
1111111111100011111              
    11111111100011111            11111111111111111
111111111111111111111            10000000N0000001
111111111111111111111            1111111111111111
111111111111111111111
111111111111111
1110000000111
110000000000011
100001111100001 
110000111000011
111000010000111
111100000001111
111110000011111
111111000111111
11111111111111
