C 212,235,248
F 255,223,204

NO Textures/wall12.png
EA Textures/wall2.png
WE Textures/wall1.png
SO Textures/wall8.png



 1111111111111111111111111111111111111
1000000000000000000000000000000000111111111111111111
10000000000001111111111111111111000000000001
10000000000001111111111111111111111111111101
100000W00000011111111111111111111111111  101   1111111111
1000000000000111111111111111111111111111110111111111
100000000000000000000000000000000000000000000000000111
1000000000000111111111111111111111111111111111111111
100000000000000000000000000000000000001
 1111111111111111111111111111111111111