C  5 , 45 , 15
F 240,240,215

NO Textures/egy1.png                    
EA Textures/egy2.png
WE Textures/egy3.png
SO Textures/egy4.png

          1111111111111111111111111111111111
          10000000010000000000000000000000001111111111111111111111111
          10000000011001111111111111111111000000000000000000000000001
          10000000011001                 1111111111101111111111111101
          10000000001001                           101            101111111111111111111111111111
          100000S000000111111111111111111111111111110111111  111  100000000000000000000000000001
          1000000011000000000000000000000000000000000000001  101  101111111111111100000000000001
          1000000011000111111111111111111111111111111111101  101  101            100000000000001
          10000000000000000000000000000000000000000000000001 101  101            111111111001111
          1111110011111111111100011111111111111111111111000111011110111111111111         1001
               1001          10001                     1000000000000000000000001         1001
               1001          10001             111111111000111111111111111111101         1001
               1001          10001             100000000001                  101         1001
               1001          10001             10000000011                   101         1001
               1001          10001             10000000001                   101         1001
               100111111111111000111111111111111111001111111111111111111111111011111111111001
               100000000000000000000000000000000000000000000000000000000000000000000000000001
               100000000000000000000000000000000000000000000000000000000000000000000000000001
               111111111111111111111111111111111111111111111111111111111111111111111111111111